AVP:
曾任天职=弼马温
徒弟=玉华城大王子,玉华州大王子
尊位=美猴王（名著小说《西游记》中孙悟空的美称）,齐天大圣（小说《西游记》人物孙悟空的称号）,斗战胜佛（接受礼忏之三十五佛之一）
师兄弟=三星洞诸师兄,玉龙,八戒,沙僧,猪悟能、沙悟净（小说《西游记》人物）、敖烈（小白龙）
天庭封号=齐天大圣（小说《西游记》人物孙悟空的称号）
类属=灵明石猴
绝技=七十二变,筋斗云,火眼金睛
来历=东胜神州傲来国花果山人氏
DESC=孙悟空，法号行者，封号齐天大圣，是中国四大名著《西游记》以及相关传说中的角色，自开辟以来的仙石孕育而生，孙悟空刚出生时，带领群猴进入水帘洞后成为众猴之王，号称为 “美猴王”。在西牛贺洲拜菩提祖师为师学艺，得名孙悟空，学会七十二变、筋斗云等高超的法术；从东海龙宫抢得的兵器如意金箍棒，身穿一副锁子黄金甲，头戴一顶凤翅紫金冠，足踏一双藕丝步云履；筋斗云一个筋斗能翻十万八千里；被兜率宫炉中之六丁神火炼就一双火眼金睛。孙悟空第一次到天界时所封官职——弼马温，因感觉职位低，返回花果山自封齐天大圣，并迫使天庭承认该封号。因醉酒闹天宫，搅乱王母娘娘的蟠桃盛会，偷吃太上老君的金丹，练得金刚之躯，阴差阳错间在太上老君的炼丹炉中炼就火眼金睛。与天庭较量中十万天兵天将不能将其打败，然与如来佛祖斗法中失利，被压在五行山下五百年悔过自新。经观音菩萨点化，被唐僧救出，保护唐僧西天取经。孙悟空一路上保护唐僧降妖伏魔，历经九九八十一难，最后取回真经修成正果，被封为斗战胜佛。在《西游记》目录或书中诗赋里，孙悟空也常称作心猿或金公。别称也有者行孙、行者孙、大圣王、大猿王、齐爷、弼马温等。
武器=如意金箍棒（神话中的神器）
体重=不详
佛祖封号=斗战胜佛（接受礼忏之三十五佛之一）
配音=李世宏（86版《西游记》配音演员）,李扬（配音艺术家）,张涵予,邱岳峰,李世宏（86版《西游记》配音演员）,李扬（配音艺术家）
兵器=如意金箍棒（神话中的神器）（定海神针（《西游记》中的兵器）、灵阳棒）
其他名称=齐天大圣（小说《西游记》人物孙悟空的称号）,弼马温,美猴王（名著小说《西游记》中孙悟空的美称）,孙行者,斗战胜佛等,孙大圣,石猴
血型=不详
年龄=与天同寿,天地同寿、日月同庚,万劫长生不老
身高=不详
中文名=孙悟空
水帘洞封号=美猴王（2010年陈家奇执导动画片）
身份=神仙,佛位
师父=菩提祖师,唐僧
信仰=道教,佛教
主要成就=大闹天宫,保唐僧西天取经,大闹天宫,西天取得大乘佛经
外文名=Monkey King,Sun Wukong,拼音：Sun Wukong,英文名：Monkey King,日文名：孫悟空（そん ごくう）,日文衍生：Son Goku
结义兄弟=镇元子,六大圣,福禄寿三星,镇元子（小说《西游记》里地仙之祖）,牛魔王（小说《西游记》中的角色）
出生地=东胜神州傲来国花果山（小说《西游记》中傲来国花果山）
登场作品=《西游记（吴承恩著作古代神魔小说）》,《上洞八仙传》,《南游记（图书名称）》,《聊斋志异（蒲松龄著文言短篇小说集《聊斋志异》）》,《宝莲灯（中国古代神话传说）》,《金刀阵》,《西游记（吴承恩著作古代神魔小说）》
知名本领=七十二变（道教法术名称）,筋斗云（《西游记》孙悟空飞行时所乘之云）,火眼金睛
性别=男
诨名=孙行者
师傅=菩提祖师（小说《西游记》的人物）,唐三藏
出生日期=春秋末期,战国初期
饰演=六龄童,六小龄童,周星驰,张卫健,陈浩民,六龄童（《孙悟空三打白骨精》等）六小龄童（86版《西游记（1986年杨洁执导央视版电视剧）》《西游记续集》）
